abase	Degrade or humble; to lower in rank, status, or
abate	Reduce, diminish
abdicate	Formally give up the throne (or some other
aberrant	Abnormal, deviant
abeyance	Temporary suspension, inactivity
abhor	Detest, regard with disgust
abjure	Give up, renounce; repudiate, recant, or shun
abrasive	Rough, suitable for grinding or polishing (such
abreast	Side-by-side. The more common "abreast of"
abridge	Reduce or lessen; shorten by omitting parts
abscission	Cutting off; sudden termination; the separation
abscond	Depart suddenly and secretively
abstain	Hold back, refrain (especially from something
abyss	A deep and vast space or cavity; anything
accede	Agree, give consent; assume power (usually as
accretion	Gradual increase; an added part or addition
acerbic	Sour; harsh or severe
acidulous	Slightly acid or sour; sharp or caustic
acme	Summit, peak, highest point
activism	The practice of pursuing political or other goals
acumen	Keen, quick, accurate insight or judgment
adhere	Stick (to), such as with glue, or to a plan or belief
admonish	Mildly scold; caution, advise, or remind to do
adulterate	Make impure by adding inappropriate or inferior
adumbrate	Give a rough outline of; foreshadow; reveal only
adverse	Opposing, harmful
advocate	Speak or argue in favor of (verb); a person
aerie	Dwelling or fortress built on a high place; the
aesthetic	Concerning the appreciation of beauty or good
affable	Warm and friendly, pleasant, approachable
affectation	Fake behavior (such as in speech or dress)
aggrandize	Make greater; exaggerate
aggregate	Gather together, amount to (verb);
alacrity	Cheerful or speedy willingness
albeit	Although, even though
alienate	Cause to become unfriendly, hostile, or
alleviate	Lessen, make easier to endure
aloof	Distant physically or emotionally; reserved;
amalgamate	Blend, merge, or unite
ambiguous	Not clear, hard to understand, open to having
ambivalent	Uncertain; unable to decide, or wanting to do
ameliorate	Improve; make better or more bearable
amortize	Gradually pay off a debt, or gradually write off
anachronism	Something that is not in its correct historical
analgesia	Pain relief; inability to feel pain
analogous	Comparable, corresponding in some
anarchy	Absence of law or government; chaos,
annul	Make void or null, cancel, abolish (usually of
anodyne	Medicine that relieves pain (noun); soothing,
anoint	Rub or sprinkle oil on; make sacred, such as by
anomaly	Deviation from what is common;
antagonize	Make hostile or unfriendly
antedate	Be older than, precede in time; assign to an
antithetical	Directly opposed, opposite; involving
apathy	Not caring; absence of feeling; lack of interest
apocryphal	Of questionable authenticity; false
apostate	Person who deserts a party, cause, religion,
apostle	Pioneer of a reform movement (originally, an
apposite	Highly appropriate, suitable, or relevant
apprise	Inform, give notice to
approbation	Praise or approval, especially formal approval
appropriate	Set aside or authorize (such as money) for a
arbiter	Judge, umpire, person empowered to decide
arcane	Known or understood by only a few; obscure,
archaic	Characteristic of an earlier period, ancient,
ardent	Very passionate, devoted, or enthusiastic
arduous	Very difficult, strenuous; severe, hard to endure
arrogate	Claim or take presumptuously or without the
articulate	Using language in a clear, fluent way (adj);
artifact	Any object made by humans, especially those
artless	Free of deceit or craftiness, natural, genuine;
ascertain	Find out with certainty
ascetic	abstinent or austere in lifestyle (adj); a person
ascribe	Assign or credit to a certain cause or source
aseptic	Free from germs
asperity	Rigor, severity; harshness or sharpness of
aspersions	Damaging remarks, defamation, slander
assail	Attack violently, assault
assiduous	Persevering, diligent, constant
assuage	Make milder, relieve; soothe, pacify, or calm
attenuate	Weaken or thin out
attuned	In harmony; in sympathetic relationship
audacious	Very bold or brave, often in a rude or reckless
augment	Make larger
augury	Telling the future, such as through
august	Venerable, majestic; inspiring admiration
austere	Severe in manner or appearance; very self-
autonomous	Self-governing, independent
avarice	Insatiable greed; a miserly desire to hoard
aver	Declare or affirm with confidence
avid	Enthusiastic, dedicated, passionate;
axiom	Self-evident truth requiring no proof;
balk	Refuse to proceed or to do something
balloon	Swell or puff out; increase rapidly
banal	Lacking freshness and originality; cliché
bane	Something that ruins or spoils
base	Morally low, mean, dishonorable; of little or
baying	Howling in a deep way, like a dog or wolf
belie	Contradict or misrepresent
beneficent	Doing good
benign	Harmless; favorable; kindly, gentle, or
bent	Personal inclination or tendency
besiege	Attack, overwhelm, crowd in on or surround
bevy	Group of birds or other animals that stay close
bifurcate	To fork into two branches or divide into two
bilk	Cheat or defraud
blight	Disease that kills plants rapidly, or any cause
blithe	Joyous, merry; excessively carefree (so as to
bogus	Fake, fraudulent
bolster	Strengthen or support
bombastic	(Of speech or writing) far too showy or
bonhomie	Friendliness, open and simple good
boor	Rude, ill-mannered, or insensitive person; a
brandish	Shake, wave, or flourish, as a weapon
brook	Suffer or tolerate
bucolic	Pertaining to shepherds; suggesting a
buffer	Something that shields, protects, absorbs
bureaucracy	Government characterized by many bureaus
burgeon	Grow or flourish rapidly; put forth buds or
burnish	Polish, make smooth and lustrous
buttress	Support or encourage (verb); a support or
bygone	Past, former (adj); that which is in the past
cacophony	Harsh, discordant, or meaningless mixture of
calumny	Malicious lie intended to hurt someone's
canard	Rumor, a false or baseless story
candid	Open, sincere, honest
canonical	Authorized, recognized; pertaining to the
capricious	Acting on impulse, erratic
cardinal	Chief, most important
cartography	Mapmaking
castigate	Criticize severely; punish in order to correct
catalyst	Causer of change
catholic	Universal, broad-minded
caustic	Capable of corroding metal or burning the
censure	Strong disapproval or official reprimand
chauvinism	Fanatical patriotism or blind enthusiasm
chicanery	Trickery, deception by knowingly false
chronological	Arranged in or relating to time order
circumscribe	Strictly limit a role, range of activity, or
circumspect	Cautious, prudent; careful to consider the
clamber	Climb awkwardly or with difficulty,
clamor	Noisy uproar or protest, as from a crowd; a
clinch	Make final or settle conclusively; to fasten
cloying	Disgustingly or distastefully sweet
coagulate	Cause a liquid to become solid or semisolid
coalesce	Come together, unite; fuse together
coda	Final part of a musical composition; an
coffer	Chest for storing valuables; financial
cogent	Very convincing, logical
collude	Conspire; cooperate for illegal or
commensurate	The same in size, extent, etc., equivalent;
compendium	Concise but complete summary; a list or
complacent	Self-satisfied, smug; overly content (and
complaisant	Eager to please; cheerfully complying
complementary	Completing; fitting together well; filling
compliant	Obeying, submissive; following the
concede	Give in, admit, yield; acknowledge
conciliatory	Reconciling, appeasing, attempting to make
concur	Approve, agree
condone	Overlook, tolerate, regard as harmless
confer	Consult, compare views; bestow or give
confound	Confuse, frustrate; mix up or make worse
connoisseur	Expert, especially in the fine arts; person of
connote	Suggest or imply in addition to the precise,
console	Lessen the suffering or grief of (verb); a
consolidate	Unite, combine, solidify, make coherent
constrict	Squeeze, compress; restrict the freedom of
construe	Interpret or translate
contentious	Controversial; prone to causing arguments,
contextualize	Place in context, such as by giving the
contraries	Things that are opposing; either of two
contrite	Remorseful; feeling sorry for one's offenses
contumacious	Rebellious; stubbornly disobedient
conundrum	Riddle, the answer to which involves a play
converge	Move towards one another or towards a
conversant	Knowledgeable about or experienced with
conversely	In an opposite way; on the other hand
convoke	Call together, as to a meeting
convoluted	Twisted; very complicated
copious	Plentiful, bountiful
corroborate	Support, add evidence to
cosmopolitan	Belonging to the entire world, at home
cosset	Treat as a pet, pamper
coterie	Close or exclusive group, clique
countenance	Facial expression or face (noun); approve or
counterintuitive	Against what one would intuitively
counterpoint	Contrasting item, opposite; a
counterproductive	Defeating the purpose; preventing the
covert	Secret, veiled, undercover
crafty	Cunning, skillful in deception or
craven	Very cowardly, lacking courage
credibility	Believability, trustworthiness
credulous	Gullible; prone to believing or trusting
crescendo	Steady increase in force, intensity, or
culminate	Reach the highest point or final stage
cupidity	Greed, great or excessive desire
curmudgeon	Bad-tempered, difficult person; grouch
cynical	Thinking the worst of others'
daunt	Discourage, dishearten, lessen the
debase	Degrade; lower in quality, value, rank,
debunk	Expose, ridicule, or disprove false or
declaim	Speak in an impassioned, pompous, or
declivity	Downward slope
decorous	Behaving with propriety and good
deem	Judge; consider
deface	Vandalize, mar the appearance of
default	Failure to act, neglect (noun); fail to
deference	Respectful submission; yielding to the
deflect	Cause to curve; turn aside, esp. from a
deleterious	Harmful, unhealthful
delimit	Fix, mark, or define the boundaries of
delineate	Mark the outline of; sketch; describe in detail
demagogue	A leader who lies and gains power by
demur	Show reluctance or object, especially for
denigrate	Belittle, attack the reputation of
denote	Be a name or symbol for
deride	Mock, scoff at, laugh at contemptuously
derivative	Derived from something else; not original
desiccate	Thoroughly dried up, dehydrated
desultory	Lacking consistency or order, disconnected,
detached	Impartial, disinterested; unconcerned,
deterrent	Something that restrains or discourages
diaphanous	Very sheer, fine, translucent
diatribe	Bitter, abusive attack or criticism; rant
dichotomy	Division into two parts or into two
dictum	Formal or authoritative pronouncement;
didactic	Intended to instruct; teaching, or teaching a
diffident	Lacking confidence, shy
diffuse	Spread widely, disseminate (verb); dispersed,
digress	Go off-topic when speaking or writing
dilate	To become wider or make wider, cause to
dilatory	Slow, late; procrastinating or stalling for time
dilettante	Person who takes up an art or activity for
din	Loud, confused noise, esp. for a long period of
dirge	A funeral or mourning song or poem
disabuse	Free someone from a mistake in thinking
discerning	Having good judgment or insight; able to
discomfiting	Disconcerting, confusing, frustrating
discordant	Harsh or inharmonious in sound;
discredit	Injure the reputation of, destroy credibility
discrepancy	Difference or inconsistency
discrete	Separate, distinct, detached, existing as
discriminating	Judicious, discerning, having good
disingenuous	Insincere, not genuine
disinterested	Unbiased, impartial; not interested
disjointed	Disconnected, not coherent, jerky; having
dismiss	Allow to disperse or leave; fire from a job;
disparage	Belittle, put down; bring shame upon,
disparate	Distinct, different
dispassionate	Unbiased, not having a selfish or personal
dispatch	Speed, promptness; send off or deal with in
disperse	Scatter, spread widely, cause to vanish
disposition	A person's general or natural mood;
disquieting	Disturbing, causing anxiety
dissemble	Mislead, conceal the truth, put on a false
disseminate	Scatter, spread about, broadcast
dissent	Disagree or take an opposing view, esp. in
dissolution	Dissolving, the state of having been
dissonance	Harsh, inharmonious sound; cacophony;
distaff	Female, esp. relating to the maternal side
distend	Swell, expand, stretch, bloat
distill	Purify; extract the essential elements of
dither	Act indecisively (verb); a state of fear or
diurnal	Occurring every day; happening in the daytime
diverge	Differ, deviate; branch off or turn aside, as from
divest	Deprive or strip of a rank, title, etc., or of
divine	Discover through divination or supernatural
doctrinaire	Person who applies doctrine in an impractical
document	Support with evidence, cite sources in a detailed
doff	Take off (such as clothes), put aside; remove
dogma	A system of principles laid down by an
dormant	Asleep, inactive, on a break
dovetail	Join or fit together
droll	Funny in an odd way
dubious	Doubtful, questionable, suspect
dupe	Person who is easily fooled or used (noun); to
duplicity	Deceit, double-dealing, acting in two different
dyspeptic	Grumpy, pessimistic, irritable; suffering from
e.g.	For example, such as
ebullient	Very enthusiastic, lively, excited; bubbling as
eccentric	Peculiar, odd, deviating from the norm esp. in a
echelon	A level, rank or grade; the people at that level
eclectic	Selecting the best of everything or from many
eclipse	The obscuring of one thing by another, such as
edify	Uplift, enlighten, instruct or improve in a
efficacy	The quality of being able to produce the
effigy	Representation or image of a person, esp. a
effrontery	Shameless boldness
egalitarian	Related to belief in the equality of all people,
egregious	Extraordinarily or conspicuously bad; glaring
egress	An exit or the action of exiting
elated	Very happy, in high spirits
elegy	Song or poem of sorrow, esp. for a deceased
elevate	Raise, lift up; lift the spirits of; move up to a
elicit	Call forth, bring out, evoke
eloquent	Marked by forceful, fluid, apt speech;
emaciate	Make abnormally thin, cause to physically
embellish	Decorate, add ornamentation; enhance (a
eminent	Prominent, distinguished, of high rank
empirical	Coming from, based on, or able to be verified by
emulate	Copy in an attempt to equal or be better than
encomium	Warm, glowing praise, esp. a formal
endemic	Native, local; natural, specific to, or confined to
enervate	Weaken, tire
engender	Produce, give rise to, cause to exist; procreate
enhance	Raise to a higher value, desirability, etc.
enigma	Puzzle, mystery, riddle; mysterious or
entitlement	Having the right to certain privileges;
enumerate	Count or list; specify one-by-one
ephemeral	Lasting only a short time, fleeting
epicure	Person with cultivated, refined tastes, esp. in
equanimity	Composure, evenness of mind; mental or
equitable	Fair, equal, just
equivocate	Use unclear language to deceive or avoid
erratic	Inconsistent, wandering, having no fixed
erroneous	Mistaken, in error; improper, morally incorrect
ersatz	Artificial, synthetic; being an inferior
erstwhile	Former, previous (adj); in the past, formerly
erudite	Scholarly, knowledgeable; possessing deep,
eschew	Shun, avoid, abstain from
esoteric	Understood by or intended for only a few;
estimable	Worthy of esteem, admirable; able to be
ethos	The character, personality, or moral values
eulogy	Speech of praise or written work of praise, esp.
euphemism	Substitution of a mild, inoffensive, or indirect
euphony	Pleasing or sweet sound, especially as formed
exacerbate	Make worse (more violent, severe, etc.),
exacting	Very severe in making demands; requiring
exculpate	Clear from guilt or blame
exhaustive	Comprehensive, thorough, exhausting a topic
exigent	Requiring immediate attention, action, or aid;
exonerate	Clear from blame or accusation; free from a
expedient	Suitable, proper; effective, often at the expense
explicit	Direct, clear, fully revealed; clearly depicting
exponent	Person who expounds or explains; champion,
expurgate	Censor; remove objectionable or offensive parts
extemporaneous	Done without preparation (esp. of a
extraneous	Irrelevant; foreign, coming from without,
extrapolate	Conjecture about an unknown by
facetious	Joking, humorous, esp. inappropriately;
facilitate	Make easier, help the progress of
faction	Group or clique within a larger
fallacious	Containing a fallacy, or mistake in logic;
fallow	Left unplanted (of land); not in use
fanatical	Excessively devoted, enthusiastic, or
fanciful	Whimsical, capricious; imaginary; freely
fastidious	Excessively particular, difficult to please;
fathom	Measure the depth of (usually of water)
fatuous	Foolish, silly, esp. in a smug or
fawn	Show affection or try to please in the
feasible	Possible; logical or likely; suitable
fecund	Fruitful, fertile; capable of abundantly
felicitous	Admirably appropriate, very well-suited
fervid	Very hot; heated in passion or
fetid	Stinking; having an offensive smell
fidelity	Faithfulness, loyalty; strict observance of
figurative	Metaphorical, based on figures of speech;
finesse	Extreme delicacy, subtlety, or diplomacy in
flag	Get tired, lose enthusiasm; hang limply or
fledgling	A young bird that has just recently gotten its
fleeting	Passing quickly, transitory
florid	Reddish or rosy; flowery, showy, or excessively
flout	Treat with disdain, contempt, or scorn (usually
fluke	Stroke of luck, something accidentally
foment	Incite, instigate, stir up, promote the growth
forage	Wander in search of; rummage, hunt, make a
ford	Place where a river or similar body of water is
foreshadow	Indicate or suggest beforehand, presage
forestall	Delay, hinder, prevent by taking action
forfeit	Surrender or lose as a result of an error, crime,
fortify	Strengthen, invigorate, encourage
fortuitous	Happening by chance; lucky
fracas	Noisy disturbance or fight; brawl
fractious	Unruly, troublemaking; irritable
frenetic	Wildly excited, frantic, distracted
fringe	On the margin, periphery (adj); the people in a
frugal	Economical, thrifty, not wasteful with money;
fulminate	Explode, detonate; attack verbally in a
furtive	Done secretly; stealthy, sly, shifty
futile	Producing no useful result, ineffective; trivial
gainsay	Declare false, deny; oppose
gambol	Frolic; skip or leap playfully
garner	Gather and store; amass, collect
garrulous	Talkative, wordy, rambling
gauche	Tactless, lacking social grace, awkward,
gawky	Physically awkward (esp. of a tall, skinny
germane	Relevant and appropriate, on-topic
gestation	Pregnancy; the period from conception until
gist	Main idea, essence
glacial	Pertaining to glaciers; cold, icy, slow,
glib	Fluent and easy in a way that suggests
glower	Stare in an angry, sullen way
goad	Urge on (as cattle) with a pointed or
goosebumps	The "bumps" created by hairs standing up
gouge	Scooping or digging tool, like a chisel, or a
gradation	A progression, a process taking place
graft	Insert part of a plant into another plant,
grandiloquent	Relating to lofty speech, esp. to the point of
grandstand	Perform showily in an attempt to impress
grating	Irritating; harsh or discordant (of a noise);
gregarious	Sociable, pertaining to a flock or crowd
grievous	Causing grief or suffering; very serious,
grouse	Complain or grumble (verb); a reason for
grovel	Creep or crawl with one's face to the
guile	Clever deceit, cunning, craftiness
hackneyed	So commonplace as to be stale; not fresh or
halcyon	Calm and peaceful, carefree; prosperous,
hallmark	A mark indicating quality, purity,
hand-	wringing
hapless	Unlucky, unfortunate
harangue	Long, intense verbal attack, esp. when
hardy	Bold, brave, capable of withstanding
harrow	Farming tool that breaks up soil (noun);
haven	Harbor or port; refuge, safe place
hearken	Listen, pay attention to
hedge	Avoid commitment by leaving provisions for
hedonist	Person devoted to pleasure
hegemony	Domination, authority; influence by one
hermetic	Airtight, sealed, isolated; reclusive;
heterogeneous	Different in type, incongruous; composed of
hew	Strike, chop, or hack (as with an axe,
hierarchy	A ranked series; a classification of people
hoary	Very old, gray or white as from old age
hodgepodge	Mixture of different kinds of things, jumble
homage	Honor or respect demonstrated publicly
homogeneous	Of the same kind; uniform throughout
hoodwink	Trick, deceive
hotly	In an intense, fiery, or heated way
husband	Manage prudently, sparingly, or
hyberbole	Deliberate exaggeration for effect
iconoclast	Attacker of cherished beliefs or institutions
idiosyncrasy	Characteristic or habit peculiar to an
idolatry	Idol worship; excessive or unthinking
idyllic	Presenting a positive, peaceful view of rural
ignoble	Not noble; having mean, base, low motives;
illiberality	Narrow-mindedness, bigotry; strictness or
imbue	Permeate or saturate, as dye in a fabric;
imminent	Ready to occur, impending
immutable	Unchangeable
impair	Make worse, weaken
impartial	Unbiased, fair
impasse	Position or road from which there is no
impassive	Not having or not showing physical feeling
impecunious	Poor, without money
impede	Hold back, obstruct the progress of
imperious	Commanding, domineering; acting like a
impermeable	Impassable, not allowing passage through
imperturbable	Calm, not able to be upset or agitated
impervious	Impenetrable, not able to be harmed or
impetuous	Passionately impulsive, marked by sudden,
impious	Not religious, lacking reverence, ungodly
implacable	Not able to be appeased, calmed, or
implication	Act of implying or that which is implied;
implicit	Implied, not stated directly; involved in the
implode	Burst inward
imprecation	Curse; prayer for harm to come to someone
impugn	Attack the truth or integrity of
impute	Credit, attribute; lay blame or
inadvertent	Unintentional; characterized by a lack of
inasmuch	In like manner, considering that
incarnadine	Blood red or flesh-colored
incendiary	Setting on fire, pertaining to arson;
incentive	Something that encourages greater action
inchoate	Just begun, undeveloped, unorganized
incipient	Just beginning; in a very early stage
incongruous	Out of place, inappropriate, not
inconsequential	Insignificant, unimportant; illogical
inconstancy	Fickleness, unreliability; the state of
incorporate	Combine, unite; form a legal corporation;
inculcate	Teach persistently, implant (an idea) in a
indefatigable	Untiring, not able to become fatigued
indeterminate	Not fixed or determined, indefinite; vague
indifferent	Not caring, having no interest; unbiased,
indigence	Extreme poverty
indolent	Lazy, slothful
inert	Inactive; having little or no power to move
inexorable	Relentless, unyielding; not moved by
infallible	Incapable of error; certain
inform	Inspire, animate; give substance, essence,
ingenuous	Genuine, sincere, not holding back; naive
ingrained	Deep-rooted, forming part of the very
ingrate	Ungrateful person
ingratiate	Make an effort to gain favor with
inherent	Existing as a permanent, essential
inimical	Hostile, adverse, harmful
iniquity	Injustice, wickedness, sin
innocuous	Harmless, inoffensive
inordinate	Excessive, not within proper limits,
inquest	Legal or judicial inquiry, especially before a
insensible	Incapable of feeling; unconscious, unaware
insinuate	Hint, suggest slyly; introduce (an idea) into
insipid	Dull, stale, lacking taste or interest
insular	Pertaining to an island; detached, standing
insurrection	Rebellion or revolt against a government or
intelligible	Able to be understood, clear
inter	Bury (a dead body) or place in a tomb
interplay	Interaction, reciprocal relationship or
interregnum	A time in between two reigns or regimes
intractable	Difficult to control, manage, or manipulate;
intransigent	Refusing to compromise, inflexible, having
intrepid	Fearless, brave, enduring in the face of
intrinsic	Belonging to the essential nature of a thing
inundate	Flood, cover with water, overwhelm
inure	Toughen up; accustom or habituate to pain,
invective	Violent denunciation; accusations, insults, or
inveigle	Entice, lure; get something by flattery,
investiture	Investing; formally giving someone a right or
invidious	Hateful, offensive, injurious
irascible	Irritable, easily angered
irresolute	Wavering, not sure how to proceed, not firm
itinerant	Traveling from place to place, esp. as part of a
itinerary	Travel schedule; detailed plan for a journey
jargon	Vocabulary specific to a group or occupation;
jettison	Discard, cast off; throw items overboard in
jingoism	Excessive, loud patriotism and aggressive,
jocular	Joking or given to joking all the time; jolly,
judicious	Using good judgment; wise, sensible
juncture	Critical point in time, such as a crisis or a time
juxtapose	Place side by side (either physically or in a
keen	Sharp, piercing; very perceptive or mentally
kindle	Ignite, cause to begin burning; incite, arouse,
kinetic	Pertaining to motion
knell	The sound made by a bell for a funeral, or any
kudos	Praise, honor, congratulations
lachrymose	Tearful, mournful
lackluster	Not shiny; dull, mediocre; lacking brilliance or
laconic	Using few words, concise
lament	Mourn; express grief, sorrow, or regret (verb);
lampoon	A harsh satire (noun); ridicule or satirize (verb)
landmark	Object (such as a building) that stands out and
languid	Drooping from exhaustion, sluggish, slow;
larceny	Theft
largess or	largesse
lassitude	Tiredness, weariness; lazy indifference
latent	Potential; existing but not visible or active
laudable	Worthy of praise
lavish	Abundant or giving in abundance; marked by
lax	Not strict; careless, loose, slack
layperson	A person who is not a member of the clergy or
leery	Suspicious or wary
legerdemain	Slight-of-hand (magic as performed by a
lethargic	Lazy, drowsy, or sluggish
levity	Lightness (of mind, spirit, or mood) or lack of
levy	Collect tax from, wage war on, or enlist for
liberal	Favorable to progress or reform; believing in
libertine	Morally or sexually unrestrained person;
licentious	Sexually unrestrained; immoral; ignoring the
likewise	Also, in addition to; similarly, in the same
limpid	Clear, transparent; completely calm
lionize	Treat like a celebrity
lissome	Flexible, supple, agile
listless	Spiritless, lacking interest or energy
livid	Furiously angry, enraged
log	Keep a record of, write down; travel for or at a
loquacious	Talkative, wordy
lucid	Clear, easy to understand; rational, sane
lugubrious	Mournful, gloomy (sometimes in an
lull	Soothe or cause to fall asleep (as in a lullaby);
lumber	Walk in a heavy or clumsy way, sometimes
luminous	Shining, radiant, well-lit; brilliant or
lurid	Gruesome or excessively vivid;
machination or	machinations
maelstrom	Violent whirlpool; any chaotic, turbulent
magnanimous	High-minded, noble, lofty; generous in
magnate	Very important or influential person, esp.
makeshift	A temporary, often improvised, substitute
malediction	A curse
malinger	Pretend to be sick, esp. to get out of work,
malleable	Able to be bent, shaped, or adapted
manifest	Obvious, apparent, perceptible to the eye
mannered	Having a particular manner, esp. an
mar	Damage, spoil, ruin
martinet	Person who adheres to rules extremely
maudlin	Excessively sentimental, showing sadness
maverick	Rebel, individualist, dissenter
maxim	A general truth or fundamental principle,
mendacious	Lying, habitually dishonest
mendicant	Beggar, or religious follower who lives by
mercurial	Quickly and unpredictably changing
meretricious	Attractive in a vulgar or flashy way,
metamorphosis	A complete change or transformation (in
metaphysical	Concerned with abstract thought, related
meticulous	Taking extreme care in regards to details;
milieu	Environment, atmosphere; the
militate	Have a great effect, weigh heavily (often as
mired	Stuck, entangled (in something, like a
mirth	Jollity, merriment; amusement or laughter
misanthrope	or
missive	Letter, written message
mitigate	Make less severe; lessen or moderate
modest	Humble; simple rather than showy; decent
modicum	A little bit or limited quantity
modish	Stylish, contemporary
mollify	Calm or soothe (an angry person); lessen or
molt	Shed or cast off, esp. to regularly shed skin,
monastic	Relating to or resembling a monastery
monotony	Sameness or repetitiousness to the point of
moreover	Besides; in addition to what was just stated
mores	Customs, manners, or morals of a
morose	Gloomy, sullen
multifarious	Diverse, having a lot of variety
mundane	Common, ordinary, everyday
munificent	Generous, giving liberally
myopic	Near-sighted; lacking long-term thinking,
nadir	Lowest point
naïve	Simple and unsophisticated, unsuspecting,
nascent	Coming into existence, still developing
negate	Deny or refute; make void or cause to be
neologism	New word or phrase (or a new meaning
neophyte	Beginner, novice; person newly converted to a
net	Remaining after expenses or other factors
nettle	Irritate, sting, or annoy
nevertheless	or
noisome	Offensive, disgusting; harmful
nominal	Trivial, so small as to be unimportant; in
nontrivial	Important or big enough to matter
normative	Implying or attempting to establish a norm;
notoriety	Ill fame; the state of being well-known for a
novel	New, fresh, original
nuance	A subtle difference in tone, meaning,
obdurate	Stubborn, hardhearted, hardened in
objective	Factual, related to reality or physical objects;
oblique	Slanting or sloping; indirect, misleading, or
obsequious	Servile, very compliant, fawning
obsolete	Out of date, no longer in use
obstinate	Stubborn or hard to control
obviate	Prevent, eliminate, or make unnecessary
occlude	Stop up, close, shut in or shut off
occult	The supernatural (noun); pertaining to magic,
offhand	Casual, informal; done without preparation or
officious	Excessively eager in giving unwanted advice
offset	Counteract, compensate for (verb); a
onerous	Burdensome, oppressive, hard to endure
opaque	Not translucent; not allowing light, heat, etc.
opine	Express an opinion
opprobrium	Disgrace and disapproval that result from
optimal	Best, most desirable or favorable
optimum	most favorable condition or greatest degree or
orotund	Full, rich, and clear (of the voice or
orthodox	Adhering to a traditional, established faith, or
oscillate	Swing back and forth; waver, change one's
ossify	Become bone or become hard like bone;
ostensible or	ostensive
ostentatious	Pretentious, boastful showiness
outstrip	Surpass, exceed; be larger or better than; leave
overshadow	Cast a shadow over, darken; dominate, make
overwrought	Overly nervous, agitated, or excited; too
palatial	Suitable for or resembling a palace,
palliate	Make less serious or severe; relieve symptoms
pallid	Abnormally pale (as skin); lacking color or
panache	Flair, style, swagger; a flamboyant or grand
panegyric	Formal or lofty expression of praise
panoply	Splendid, wide-ranging, impressive display or
paradigm	Model or pattern; worldview, set of shared
paradox	Contradiction, or seeming contradiction that
paragon	Model of excellence, perfect example
pare	Peel or cut off the outer layer (such as peeling
pariah	Social outcast, untouchable
parley	Discussion, negotiation, esp. between
parry	Deflect or avoid (esp. a blow or attack);
partial	Biased, prejudiced, favoring one over others;
partisan	Devoted to a particular group, cause, etc.
pastiche	Mix of incongruous parts; artistic work
patent	Obvious, apparent, plain to see (adj); a letter
pathogenic	Capable of producing disease
pathological	Relating to or caused by disease; relating to
patronizing	Condescending, having a superior manner,
paucity	Scarcity, the state of being small in number
peccadillo	Small sin or fault
pedant	Person who pays excessive attention to book
peddle	Travel around while selling; sell illegally; give
pedestrian	Ordinary, dull, commonplace
pejorative	Disparaging, derogatory, belittling (adj); a
pellucid	Transparent, translucent; clear, easy to
penchant	Liking or inclination (usually penchant for)
penitent	Regretful, feeling remorse for one's sins or
penumbra	Outer part of a shadow from an eclipse; any
penury	Extreme poverty or scarcity
per se	Intrinsically; by itself; in itself
peregrinate	Travel from place to place, esp. on foot
perennial	Lasting through the years or indefinitely,
perfidious	Disloyal, treacherous, violating one's trust
perfunctory	Done superficially, without much care, or
peripatetic	Journeying from place to place; traveling on
peripheral	Relating to or making up an outer boundary
permeate	Spread or penetrate throughout
pernicious	Very harmful or destructive, deadly
perspicacious	Having penetrating insight or good
pervasive	Tending to spread throughout
phalanx	Formation of soldiers carrying shields close
philanthropy	Efforts to improve the well-being of
philistine	Person deficient in or hostile to culture
phlegmatic	Apathetic, sluggish, not easily excited or
phony	Fake, counterfeit; insincere, not genuine
pious	Devout; religiously reverent and dutiful
pith	Core, essence; significance or weight
placate	Satisfy or calm down (an angry or
placid	Peaceful, calm, tranquil
plastic	Able to be shaped or formed; easily
platitude	A shallow, overused statement; cliche
plausible	Believable; having the appearance of truth
plebian	Of the common people
plethora	Excess; excessive amount
plucky	Brave, spirited
plummet	Plunge, fall straight down
plutocracy	Rule by the wealthy
polarized	Divided into sharply opposed groups
polemic	Controversial argument, esp. one attacking
politic	Shrewd, pragmatic; tactful or diplomatic
polyglot	Speaking or composed of many languages
ponderous	Heavy; bulky and unwieldy; dull, labored
posit	Presume, suggest, put forward (an idea)
posthumous	Happening or continuing after death
potentate	Ruler, person of great power
pragmatic	Practical; dealing with actual facts and
prattle	Talk in an idle, simple-minded,
pre-empt	Prevent; take the place of, supplant; take
preamble	Introductory statement, preface
precarious	Unstable, insecure, dangerous
precipitate	Cause to happen suddenly or prematurely;
précis	Concise summary, abstract
precursor	Something that comes before, esp.
predilection	Preference, tendency or favorability
predisposed	Having an inclination or tendency
prescient	Having foreknowledge or foresight, seeing
presumptive	Based on inference or assumption;
presumptuous	Too bold or forward; going beyond that
pretentious	Claiming or demanding a position of
preternatural	Supernatural, exceptional
prevaricate	Stray from the truth, mislead, lie
primacy	The state of being first or most important
principled	Having high moral standards
pristine	In an original, pure state; uncorrupted
probity	Honesty, integrity
proclivity	Inclination, natural tendency
prodigal	Wasteful, extravagant; giving abundantly,
prodigious	Extraordinarily large, impressive, etc.
profligate	Completely and shamelessly immoral, or
profound	Very insightful, penetrating deeply into a
profuse	Abundant, extravagant, giving or given
prohibitive	Tending to forbid something, or serving to
proliferate	Increase or spread rapidly or excessively
prolix	Excessively long and wordy (of a person,
prologue	Introductory part to a book, play, etc.
pronounced	Distinct, strong, clearly indicated
propagate	Reproduce, spread, increase
propensity	Natural inclination or tendency
prophetic	Relating to prophesy, predicting, ominous
propitiate	Attempt to reconcile with, satisfy, or reduce
propitious	Favorable, giving good signs for the future,
propriety	Conforming to good manners or
prosaic	Dull, ordinary
proscribe	Prohibit, outlaw; denounce; exile or banish
prospective	Potential, in the future
providential	Lucky, fortunate, or relating to divine care
proxy	Agent, substitute, person authorized to act
prudent	Wise in practical matters, carefully
puerile	Juvenile, immature
pugilism	boxing, fighting with the fists
pugnacious	Inclined to fight, combative
puissance	Power, might
pulchritude	Physical beauty
pungent	Having a sharp taste or smell; biting,
pusillanimous	Cowardly, timid
qualified	Modified, limited, conditional on
quandary	Uncertainty or confusion about what to do,
querulous	Given to complaining, grumbling
quibble	Make trivial arguments or criticisms, find
quiescent	Quiet, still
quixotic	Extremely impractical but very romantic,
quotidian	Daily; everyday, ordinary
raconteur	Witty storyteller
ranks	Personnel; a group of people considered all
rarefied	Lofty, very high up or elevated (in a
reactant	Something that reacts; a substance that
reap	Harvest, such as by cutting; gather; get as a
recalcitrant	Not obedient, resisting authority, hard to
recant	Withdraw, retract, or disavow something one
recapitulate	Summarize, repeat in a concise way
recluse	Person who lives in seclusion
recondite	Not easily understood, hidden, dealing with
recrudescent	Revival, breaking out into renewed activity
redound	To have a good or bad effect, esp. as a result
redress	Setting something right after a misdeed,
refractory	Stubbornly disobedient, hard to manage
refulgent	Shining, radiant
refute	Prove to be false
rejoinder	Response or reply, esp. a witty comeback
relegate	Send or commit to an inferior place, rank,
remedial	Providing a remedy, curative; correcting a
rend	Tear violently, esp. to tear one's clothing or
render	Give, submit, surrender; translate; declare
repast	A meal (noun); to eat or feast (verb)
repertorial	Pertaining to a repertory or repertoire, a stock
replete	Supplied in abundance, filled, gorged (used
repose	The act or state of resting; peacefulness,
reproach	Blame, disgrace (noun); criticize, express
reprobate	Disreputable, unprincipled, or damned
repudiate	Reject, cast off, deny that something has
requite	Reciprocate, repay, or revenge
rescind	Annul, repeal, make void
resolution	The quality of being firmly determined;
resolve	Find a solution to; firmly decide to do
respectively	In the order given
restive	Impatient or uneasy under the control of
resurgent	Having a revival, renewing, rising or surging
reticent	Not talking much; private (of a person),
retrospective	Looking to the past or backward; applying to
revamp	Renovate, redo, revise (verb); a restructuring,
reverent	Feeling or expressing very deep respect and
rhetoric	The art or study of persuasion through
ribald	Using or relating to obscene or vulgar humor
ridden	Dominated or burdened by
rife	Happening frequently, abundant, currently
rift	A gap or fissure (such as in rock), a break in
rococo	Very elaborate and ornate (in decorating or
rudimentary	Elementary, relating to the basics;
rue	Regret, remorse (noun); to feel regret or
ruminate	Turn over in the mind, reflect on; chew cud
rustic	Relating to country life, unsophisticated;
sacrosanct	Sacred, inviolable, not to be trespassed on or
sagacious	Wise; showing good judgment and foresight
salient	Obvious, standing out; projecting,
salubrious	Healthful, promoting health
sanction	Permission or approval, something that gives
sanguine	Cheerfully optimistic, hopeful; reddish, ruddy
sap	The inner fluid of a plant or any essential
sardonic	Scornfully or ironically mocking, cynically
satiate or	sate
saturate	Soak or imbue thoroughly; cause a substance
savant	Learned person, scholar, someone admitted
savor	Appreciate fully, taste or smell with pleasure
scant	Not enough or barely enough
scathing	Severe, injurious; bitterly harsh or critical (as
scintilla	A tiny bit or trace
scurvy	Contemptible, mean
searchingly	In a searching or penetrating manner; while
secrete	Produce and release a substance from a cell
secular	Not religious or holy; pertaining to worldly
sedition	Inciting rebellion against a government, esp.
sedulous	Persevering, persistent, diligent in one's
semantic	Relating to the different meanings of words
sentient	Conscious; experiencing sensation or
seraphic	Like an angel; serene, spiritually carried off
shard	Fragment of some brittle substance, esp. a
simultaneous	At the same time
sinecure	A job or position that pays while requiring
skeptic	Person inclined to doubting or questioning
skirt	Border, lie along the edge of, go around;
skittish	Shy, fickle, uncertain, or prone to act
slack	Loose, negligent, lazy, weak (adj); neglect to
slake	Satisfy (esp. thirst), cool, or refresh; make
slew	A large number or quantity
slight	Small, not very important, slender or delicate
sobriquet	A nickname
solecism	Nonstandard use of grammar or words;
solicitous	Concerned or anxious (about another
solidarity	Fellowship in interests, feelings,
somatic	Of the body
soporific	Causing sleep; sleepy, drowsy (adj); something
sound	Measure the depth of (usually of water) as with a
spartan	Very disciplined and stern; frugal, living simply,
spate	Sudden outpouring or rush; flood
spearhead	Be the leader of
specious	Seemingly true but actually false; deceptively
spectrum	A broad range of nevertheless related qualities
speculate	Contemplate; make a guess or educated guess
sporadic	Occasional, happening irregularly or in
sportive	Playful, merry, joking around, done "in sport"
squalid	Disgusting, filthy, foul, extremely neglected
squelch	Crush, squash; suppress or silence; walk
standing	Status, rank, reputation (noun); existing
stark	Complete, total, utter; harsh or grim; extremely
stasis	Equilibrium, a state of balance or inactivity, esp.
static	Fixed, not moving or changing, lacking vitality
status quo	Existing state or condition
steeped	Immersed (in), saturated (with)
stentorian	Very loud and powerful (generally of a human
stigma	Mark of disgrace, a figurative stain or mark on
stingy	Not generous with money, reluctant to spend or
stint	Period of time spent doing something, or a
stipulate	Specify; make an open demand, esp. as a
stoic or	stoical
stolid	Unemotional, showing little emotion, not
stratagem	Military maneuver to deceive or surprise;
stratum	One of many layers (such as in a rock
strut	A structural support or brace
stymie or	stymy
subjective	Existing in the mind or relating to one's own
sublime	Lofty or elevated, inspiring reverence or awe;
subpoena	A court order requiring a person to appear in
subside	Sink, settle down, become less active; return to
substantiate	Support with evidence or proof; give a material
succeeding	Coming after or following
sully	Make dirty, stain, tarnish, defile
supersede	Replace, take the position of, cause to be
supplant	Take the place of, displace, especially through
supplicate	Pray humbly; ask, beg, or seek in a humble
supposition	Assumption, hypothesis, something that has
surfeit	Excess, excessive amount, overindulgence
surly	Bad-tempered, hostile, unfriendly, or rude
surmise	Guess, infer, think, or make an opinion with
surrogate	Substitute, person who acts for another
sybarite	Person devoted to pleasure and luxury
sycophant	Servile flatterer, parasitic person who fawns
symbiosis	Mutually dependent relationship between two
synchronous	Happening at the same time; occurring at the
synoptic	Relating to a synopsis or summary; giving a
syntax	The rules governing grammar and how words
table	Lay aside to discuss later, often as a way to
tacit	Understood without being said; implied, not
taciturn	Not talking much, reserved; silent, holding
tangential	Only slightly relevant, going off-topic
tawdry	Gaudy, cheap or cheap-looking; indecent
temperance	Moderation, self-control, esp. regarding
tendentious	Marked by a strong point of view, biased
tenuous	Long and thin, slender; flimsy, having little
terrestrial	Relating to the Earth or to land; worldly
terse	Concise, brief and to the point (sometimes to
timely	Well-timed, happening at a suitable time
timorous	Fearful, timid
tirade	Bitter, abusive criticism or verbal attack
toady	Someone who flatters or acts in a servile
token	Sign, symbol, mark, badge; souvenir,
tome	Large or scholarly book; one of the volumes
torpor	Sluggishness, lethargy, or apathy; a period of
torrid	Very hot, parching, burning; passionate
tortuous	Twisting, winding, complex; devious, not
tractable	Easily controlled or managed, docile; easily
transgression	Violation of a law, moral rule, order, etc.;
transitory	Temporary, short-lived, not lasting
travesty	Exaggerated, debased, or grotesque
treacherous	Betraying trust, not faithful or trustworthy;
trenchant	forceful or vigorous, effective, keen;
trifling	Trivial, not very important; so small as to
trite	Lacking freshness and originality, lacking
truculent	Fierce, cruel, savage; belligerent
tumultuous	Riotous, violently agitated, marked by
turgid	Swollen, inflated; or, metaphorically
turpitude	Depravity, baseness of character, corrupt
tyro	Beginner
ubiquitous	Existing everywhere at the same time
umbrage	Offense or annoyance (usually as take
unconscionable	Not guided by conscience; morally wrong,
undermine	Weaken, cause to collapse by digging
underscore	Emphasize (or, literally, to underline text)
unearth	Dig up, uncover, expose
unequivocal	Unambiguous, clear, absolute; having
unprecedented	Never before known or seen, without
unseemly	Improper, inappropriate, against the rules
unsparing	Generous, lavish (as in not sparing any
untempered	Not toned down; not moderated,
upbraid	Find fault with, criticize or scold severely
usury	Charging interest on a loan, esp. charging
vacillate	Waver in one's mind or opinions, be indecisive
vanguard	Leading units at the front of an army; leaders in
variegated	Varied in color, having multicolored patches or
venerate	Revere, regard with deep respect and awe
veracity	Truthfulness, accuracy; habitual adherence to
verbose	Wordy
verdant	Green, such as with vegetation, plants, grass,
verisimilar	Having the appearance of truth, probable
vernal	Relating to the spring; fresh, youthful
vestige	Trace or sign of something that once existed
vex	annoy or bother; puzzle or distress
via	Through, by means of, by way of (by a route
viable	Capable of living (or growing, developing, etc.);
vicissitude	Changes or variations over time, esp. regular
vim	Pep, enthusiasm, vitality, lively spirit
vintage	Related to items of high quality from a previous
virtual	Existing only in the mind or by means of a
virulent	Extremely infectious, poisonous, etc.; hateful,
viscid or	viscous
vitriol	Something highly caustic, such as criticism
vituperate	Verbally abuse, rebuke or criticize harshly
vociferous	Noisily crying out, as in protest
volatile	Varying, inconstant, fleeting; tending to
voluble	Easily fluent in regards to speech
wan	Unnaturally pale, or showing some other
wanton	Reckless, vicious, without regard for what is
warranted	Justified, authorized (warrant can mean to
wary	Watchful, motivated by caution, on guard
welter	Confused mass or pile, jumble; confusion or
whereas	While on the contrary, considering that
whet	Stimulate, make keen or eager (esp. of an
whimsical	Marked or motivated by whims (odd, fanciful
whitewash	A substance used to whiten walls, wood, etc.
wily	Crafty, cunning, characterized by tricks or
winnow	Sift, analyze critically, separate the useful part
winsome	Charming, engaging, esp. in a sweet and
wizened	Withered, shriveled
xenophobia	Fear or hatred of foreigners or that which is
yoke	A burden or something that oppresses; a frame
zeal	Great fervor or enthusiasm for a cause, person,
zenith	High point, culmination
